ООО Кузченко О.Д. (ООО КОД)	Market
ООО Ландышев Д.В. (ООО ЛДВ)	Your Store
ООО Богдашкин Р.Р. (ООО БРР)	Phone Talk
ООО Гусейнов А.И. (ООО ГАИ)	СмартБУМ
ООО Балюк Р. Н. (ООО БРН)	На связи!
ООО Конюхов К (ООО ККЮ)	Секретный код!
ООО Усков А.О. (ООО УАО)	MyDevice
ИП Кристя Д.В. (КрДВ)	Telefonica space
ИП Ахмедов Э. Б. (АЭБ)	Mobile Paradise
ООО Попова А.А. (ООО ПАА)	Cyber smart
ООО Онищенко С.В. (ООО ОСВ)	Бабушкин смартфон
ООО Батов И.К. (ООО БИК)	Умный гаджет!
ООО Кунаев Д.В. (ООО КДВ)	Твой выбор!
ИП Гусейнов А.И. (ГАИ)	Spice Digital
ИП Филатов Ю.А. (ФЮА)	Ultra mobile
ИП Попова А.А. (ПАА)	Smart Point
ИП Мелькин Р.А. (МРА)	Screenshot
ООО Филатов Ю.А. (ООО ФЮА)	ClarityWave 
ИП Онищенко С.В. (ОСВ)	iTech
ООО "Сопин Р. Д." (ООО СРД)	Телефономания
ИП Ахмедов Ш. Б. (АШБ)	Crazy iPhone
ИП Кузченко О.Д. (КОД)	iPhone company
ИП Веретенников С.М. (ВСМ)	Mobile shop
ООО "Фаворит" (Ф)	Mobile Planet
ООО "Экспресс" (Э) + (ЭД)	iPhone Express
ООО "Позитив" (П)	Mobile.store 
ИП Демина А.В. (ДАВ)	Mobile premium
ИП Веретенников А.С. (ВАС)	Надежные смартфоны
ООО "НС" (НС) + (ЭД)	Smartmarket
ООО "Лидер" (Л)	Best smartphone
ООО "Миллиард" (М)	Новые решения
ООО "Развитие" (Р)	Мобильный мир
ООО "Свежий ветер" (СВ)	Expert Mobile
ООО "НСП" (НСП) + (ЭД)	Mobile Boom
ИП Батов И.К. (БИК)	MobilePro Solutions
ООО Мелькин Р.А.  (ООО МРА)	Dual smash
ИП Мележик И.А. (МИА) 	Secret Bridge
ООО Саенко К.В. (ООО САКВ)	iPhone mission
ООО Мележик И.А. (ООО МИА)	Future
ИП Гущин И. Н. (ГИН)	DevicePoint
ООО Ярков А.Д. (ООО ЯАД)	Mobile Airtel
ИП Голубев Д.Е. (ГДЕ)	Mobile market
ИП Порохов (ПАС) 	iPhone Place
ИП Ретивых А.С. (РАС)	Device Authority
ИП Филимонов И. И. (ФИИ)	Mobile Leones
ИП Сивов Р.А. (СРА)	Citywide iPhones
ИП Сафин М.Д. (СМД) + (ЭД)	Gadget Hub
ИП Плохотнюк И. А. (ПИА) 	Smart on Track